0100110100101000001101001011101011111001111000000010110010000111111001110000001010000001001100001111
1001111000001001110111100000011101011001011111111110011001111100010000110101000101010010101110110111
0101000001100001000001010010111110010110000001000101110011110110111000111100010101101000000100011000
1111000111010010000010111110011001100010000101000011011111100001000010000111111111000100100110000000
1000101110011011001001110101001010101101111110000100000100111010101110010010111001100010010100111110
1011100100000001110011001010001110110101100101010111100010100110011000100110101101000001111011110100
1111111111000000101100100100101110000000111001011100100010000010001100100011110101000000101010010100
1110001000000101110110000001101001110010100101011000010010010000100011000000101100110110000111100111
1100000001110110101011001111111100001110000100001000100101110111010101001011100111100011100011110111
0010100010011010011000001001010100001011011100011011101111000011011101101001010001110110011101010010
1011000001100000101010000100001011010111000111111011100010111111010000000111010000100100110001100001
0000100010000100010011010010001011001101111111101100011110000011110011110011101100001101100111100100
0000000011110111111101010011000001110001011000000100110011110010001011111100110010110001000110110110
0100101010111001010111101101101101111001000100101100001100010000010011010111111001000110111110100011
1010101110110101000000000110100101111010111001001001010010110010111001100010111001111100000100001000
0111111011100110101001101111101010100000010101111101110010011110001001001100100110001100101101010001
1001010100111100010110101000000100011011010101000101100111110011000111110001100111000110100110100111
0000101100101000100000010011111100100111001000001001011010011100000011001001001001110100111100010000
1001010101010110101001100100001010011011001111001000100001100011000011001110000011110001011010110000
1000111101111101101000101001101101011001101111111111110011001100101000100100101110001110000111001010
0101010101001110000010101001001101000111000110000001011011000011110000111101110010011010100000000101
0001010001011011010000010111000000010000110001000100100110001001111100000110111100000001101010000110
0001110010001110011011110000100101011101100101011110010111101011110000011010101111101101110100111001
1100100010011011011011110100000010111111110010100010111100111010111011101001111110001001101011101100
1100010010101000111111001110001110011010101100000100001010111110110111101110011000101010110000010100
0100101100011100011010101001111011001001110011001110010001000011110110100101111111110001100000110001
0100100010010010100011010010101001101001000110110100010000100001101100010101011101100100111001000101
0100111100111110011001000101101100100000000001001101110110000011111110001110101011001010100001010000
0011001101111011101101111001010011001010010100011010001111001011100000100101011000000001001001110101
0001110111101010110101010000011111011011000001001100010001001000010100100001111010101001011110110110
0101011001100100100000110100011000110010000000101111011001001111010111011010000011010011000110101011
0001111000110011010000110101001001100101100010111000110101110010100010100100101100011100010000000000
1101111001100000100000100111001111101000101001110111100010111001000001001111101001111100001101111000
1010011110110111100101011010010111000010110010001000101000101010110100010111101100001010010110101100
0100110000000111000111001001010000101001100111110011100000101000101010010110101011101111010101001110
1111100000011001101011111101110101000110000001011100110110111001000001011001000110111111101011111101
1111111001000010110001000111101010110001100100111001011110100101111010001000010110001000010111001010
1001100010111100111111111010001101111011110000100100110110010001100101010110011011100001010001100110
0010000001111101000010000100100001100100010011000100011010111100101000111010000111100100110100101111
0110010000100001110001111100001011110100000011001010011011110101011000001110110111110001011110111010
1110000101000010100011011101001110100100111010101101001010101000101010111100101100111010011011011010
1010001101100010111010100011110000000111000101100010010100010000010001011011001010111010011101011011
1001101100110100101011000100101111010010000110110101001100011011000011101011000110011000001100101101
1011100010101010110001011000111110111110100011001111111001100100110101111110101100100111100110110000
0111011111100001001010001011010011010010110110111001110010011100101000100011000101110011100111011111
1011101111011100111111101100101101111000101001001000011010000101101011110100111100001000001010110110
1101111011111110110010011011000010010110011111111001001101101111111001111000000011000101000001001001
0111010010111011010101010011111101000100110011010100111101010111001001000110010111111101001101110101
1111111100001100100010000011101110100110000001101100000000100011011110001101110000000110101101011111
0111000101001000000101000101011110011011011100100000100000011100000000110000000100100101001001000110
0010000010101001100110101101001110011010111101110110101000101000000011010000101100100100100000110110
1111010000110010001110101010001011111010101110110001011010000111111101011011010010110010100001000001
1010110001000110110111110110111011111110100100000100110110000110110000011101100110100001000110010110
1001011110000111111100110000000001101110011011010101101000110110100111101011110010011010101001111110
0011100110111110000110100111101000010010011001011100111011100011011011100111110011110000001001100011
0111101000100110011101010001110111001101100111100011111001100010000011110001010111110010000011101100
0100100010011001000110000111000000000101101010100000110111100001011101100100101000010101010101001111
1101101110100001001011010000010101111111100101001000001000010011101110000010100000011100110011101100
0011001001010111100000110010000000101111000101010101100000101100000011000001111001000110000010100011
0000101111001000011000101110011011101100111001000011111011100010011010110001110100100101010100110111
0011010000000111011001110110001011110011100111010110111011011010111000001001011010101000111111000101
0000101110011110101101001010010100001101001111101001011010110100111110011010111101101110011011001011
0010110110011000111011100100111010111111001111101010000000000011110100110100010001100110101100011010
0101001000000001000110010101001101100100110011100100100000001101110111011011011011101000011110111011
1011110011101010110111000110001010111100001111111010011110101100011101010001111001100100100011000000
0101100110100110000010100111101101001001001101010100011111011100101100010110010101001011100001100010
1110110110111000001001010011000000000011100101110010101111101101101110000010010100110111100011010110
0011111001110000010110110100100001111101011010101101111011000111111101001001111010011101111101000000
1111111101110101111011100100000000011110111000001100010010111011011101100011110000010100001101111101
1011101000110000110000100000101001111010001100100101110000100011100110110001110110100100001111001100
1100010010101011001010100010010110010110111011001011010100100001011110100011011111010100100110000000
1100111000101100110010001101110010001111011101000000010010110110100101111101001000011011101001011000
0111110000100001100011011111000100101010101100001001011101000100001111100110011110011111000100001000
0001110000001011001011101000010001010111100111110100011100000000010111000101110010101101101111011000
1110101011101010000000101101111101010111111000011101101110011101010111010111101001110011110011001100
0010010111001000111100111001000011101010100111011101011000110010101101100110010110000101100001110010
0110100011010110111011110111110011100000000000011000110101000010010111010101101100001111100101111001
0111001101010100000010110101011101010000010100000010001000110000000100101001001111000110110001011011
1010111010101000110111001001110100000000000011111000010000101111101101110101110101001101010111110001
1001110011110010000111010001000101010111101001101110011111001000000100000000001000111110101100111010
1010110010010010011001110101011011011111111101110111010110111010111110111010110110101000111101001111
0111001110111011010110110000100000010111011000000110010110011110000000111000000011001010110001100110
0111101101000100001111100000110000010000111100010100010110001010011110111100000101011001100000111010
0010110111100011111011101100100110110100111110110110000101110110110101000110110011111111011100111000
1100010110100011111011011011001100101011110000011111010101001111111000101100000001101100010000001100
0011101001111100011000011111001110000100100100010100000100111100110111000000000011111100111110001000
0010101010000110000001001000000011010001000111101010001111000011100100001000001101100100100001010110
0111100111000111100010110110010010011010110110100111111001000100111011010111110001011011111011000111
0111110000000011010111011011010101001101000001001100011011011111001110010100100101111011000001100011
1001000111011101001100110100010100100101110110110100110011001011011000000001000010000010101111110101
0011000011100110101001111001101101101101101111110000110000010111111100111110000011110001001111011110
0001001101110011101001001110011000110100000011101110110001011100110110100111011011101011111100010010
0101100000101100110100010111100101100000111100100010001011001110010010011100001011100010101010111111
0000001111101011011010111010001101001110100100011010101110111111010000010001100010110110111011000110
1011110111010001001000010010001101101001000111010001000000010101001111000110001011011110101010001110
1000010110100101100010110101011001001111001000110111010001111111111001100010011111111001001100011101
0101101101010010101011100001010110100101011011010011001111111000010101110111100001010000100000110000
0001011110111010100111010000111000001100010111001110010010000110000011100011011110000010011110001110
0001110000001001010011010101101110111100010010101000010000001010110101000011110100110011110100111011
1010110111001110011110100100111101001100011001000111100001011000100110011111010010110010101111111001
