1110100111001001001001111001011000001010111001101000110101010001111010001010111011001000000111111100
1111001100010110011010010110101101010101100111110001001110100100011011101101100000110110011100100001
1011110111101011010101111100011100110011000110010000101100101001010101110110001010001111110110000010
0010000111010100110111000001001110011100000101001010101000101011000111000010001110100001000010011101
0010010010010010111001001000101110100101010111101111111110000111110100101001101110001001000111011100
1011100000101001010100011001101101100111010100001101110100100100010110000100011111011100100111101101
0011111110110000010111100011001110101000000011100011110000100111101000111111101110111100100111010000
1110110110001001001010000110011011111010010001110110010101101000101011111011100011101111011010111101
1101000100011011010001111001111000100101001101101101000110110110011110011111010101100101101010000011
1100110101011010110010110111110000111001111100111111100011010100110101010001111111100010111101000100
1010111000001000100100111000000010011111010000101001111100101110000111001010100100111000101000110011
0111000100010111111110101111010100101110110010100000011011101010000111111010110110101000010111110100
1101011011011110111111100000000100101011110010111101010001001010000010110000000101111101101011011000
0100011111100110010000010100111101000111110000101100110011110100111100111011010101011111111110101001
1001101100010010111001111101010101010110111000000101011001110101100001010011101101011101111110001101
1010111001111000001100110000000100010001001100000001000011011110010111111101100110001000011011000010
1100100010100011101001110111101100001110101101100010110110100011001011000010111101101101100011001100
1111110101101101011101110001011011111100111100010101000000011000010000101000100000100101011011010110
1100100111101011111010010010010100101011000100001111001000000001111000010101001110010110100000111001
0100011111110010011001010001000000101000001011110101101100100010100100101011000110111101000000011101
1110010011011101011011101000011100111011010001010011101011010011110110110000011101111011110000011110
0101111110110100000010100000001101011000011010101111110011001110110111010010100110011001101111011001
1110110101100011001100100010110111100111101111101110011100001011000010101100011010001001011010010001
1001001001010010000110001101011011110111010100101010111011011101101101011011000001111110011000111000
0110111100010000001011000100111011110110111111010011011100000010101001011100110110100110000100000001
1011101100110100100000000111111000101110000100101111001000000011011000010110011101100111101000110011
0110000011000110010001001001100111110111011010110000001011001000001110100111100100000000011011110100
1000101010100100010111011110100001110101011000101100111110110110111000100101101001100001001110100000
1010110001100001110101010001010000010111100011101000111100011110101010110010010010110001010110000111
1001111000100100000001000010100000011000111101100001101010110110000110001100111110100011110001101001
0001100101011101111001110111100010111011110010100101000110101010010110100010111001010101010010010100
1101001001100010110101111100011100111010000000010000111100011001000001011101100010000001001010011110
1010111101101110011000001110000111001100111101001001110011101000000001101111111011100100000001010101
1101000001100110100011111100110111111010011101111111111000001110011010001111000001111110110111100010
1100100011101001100100001100001011000101110001111011010111101111110110001110011111110010000110010000
0011011010010011001100001010100101001100010110010101000010011110110110011101100111100001111111111000
1011001101000101000101101001000000111011110011001010110001101101010000010111001110101000110011001111
0010100000000010100101111100101010010000111001111010001101111100001000011001101110101110000000011011
0100111000100001011110111011101011010010000111010001110100000101100011100101010011001110100100101110
1001100110110101100101101000111101000011100000011110000000100100101011111000011000010111011100101110
0111111010101001101010000010101101110000001001111101010011011100010100000011010101101000111101100000
1101100010111001000001100010000101000110000110000110000100110110101110100001011001100000110011101001
1001110001000000110001000100101111010100100110111000101111010000000101110100000100100101110000011101
1101001000010010011111010101100110001001110010100000101011000110111001100100010001101100110100010111
0110001011100101111101010110001000111000010011111100110000011110101101001110011101001110110001111110
1110010100000011101010100111000100000010101000001110011100001110100101111111010110110101100000111100
1100111101001100011010011011101111001001001010110010011001101110111011111110111100111001000110010000
1101110000100001010001110110001110000110010000110100001001100111001000111110100001101011011110000010
0110010101010000111001110011110111010010101011110000011011110000111100011011010010100101101010011000
0101100110010000011011110011011111110100100001110001110110001110110000100001100001001110010011101010
1101000101101000011111110110011110101010100100011001010001010000111100011100000010101110011000111000
0001100001000000110101010011000011100010100111100001100111101001100001101001110010110001011101010110
1101100001010111010101110000011010010101111001100111010111100111111011010111101110000011011010011100
1010111010110111010110000000100000100101101010010000010100111001010000110011011110100001000000101001
1110001010100001000010001111000011111111110101000111010001111001011100000110000100001100100101000110
0110111110101110011011111110000110110011001010011110011011111101001001010010110001110000011001101001
1000001101011110110011001001010010000011110000001010110000110110101011011101010110111001011001000000
0101011111000101001100111111111111001011000100101100111110000011000100000111110000100001101101101000
1000101000100001010000110101101100110100011011011010001010010011011001010111000010100101001110001110
0100000110000010000011101011110101100000111001000011010001100010101111001011110011010101010100110011
0101100011101010100011011011111101101001100101011011110001011000110101001101110100111111000111001011
0110101111100111010101111010000000011001001110101011111101000000011110010011100110010111000100001011
0110001000010001100010100001110001101000000010001001111110011101101010010100111011111011010100011110
0011110101000000011000010001001010000110110111000000111101001100100101101101101010010000111110010101
1011000010100011100010010110011101100010000010101011110001011111110111110001100111000101010001001101
0011101101110000101011000110010011100101000011011110011010111100000001101101100011110100011111001111
1000000100001100010111010110001110001000001011000111010111010111000111011010101011111010000001111110
1110001001001101001001111001111001010110001101110101100111010110001000011111001000111101000010011101
1101001110100111110101011010111001011000000101010110101010111110000111011110011100110011101000100111
1100100000011011110001000110000000100111011001110100001100000010001110100001100101111011101011000111
1010110100010001010110011110101111011100001001111001001011000111011101010101000111110100011010101011
1011111100111010111110000011100000010010010101000111100101110101000011101110011110001000101010001111
0100001100010101011110101101111000111000101001100111000101110100011001011100111000110011000110110000
1111100110011110100011001110000000101101010100111011101101101001101011010000111100001011110000000010
1111101110001011000100001000000000000111000010000100001101100100010000111000100010000100001101111001
1010110010101111000101110111111100100000101101000110110010001011001011000100010101000100011101010110
1001100000000010111101110010011000110100100110010110111111101000101110110011100001100001111110010010
0010111101111111100010111110000101001110000000011000111010101111100011110101101101000111001110010001
1000000110010101101010111000000110011010010011111100011100011111111110100000000001111101100000101001
0100011001110001010011110101001111111100000110001111100011001001100100111101111100010110010100101100
0001000010000111100001101000001101000110100000011100000000001010110000101010111000000010110111101100
0011110100010100001010000001110001111000100111111001100001101100001101011100110111110110110000100001
0100100110010110010111101100001100001110001101000101110001100110101010101111110101011000111111000110
1100110000101100110011001100001111100111111010111011010101110100011111010010101111111000110010100001
1101110010010101001000010100001000101001101010011110011010101010100110001110011000111011101111101100
0101100000111101110110010101101011100110111100011011111111000100010001001001101100010100000001010100
1100111111111001100000111100011111111110010011110100010101110101111001100110000110011000010110110110
0111001010111110111010010101000000110111111000001001110001101101111000100111111111101111111000111000
0010000010010001100101010110111111111001111111011111111111100111101101101101111101110000110000111000
1101000100000010110001011100010110101010100111111001011011011000111001011010110010010100101100010001
1111110110001000100010001100000101100101111011010101001110101001101000100101100010010110101101000001
0110100001000111000100101111111000110101101010010101010001000001100001000101110010010111011001111010
0101000100011010001101101101011010111100001111100010110101110001011110010001011001110010101100011001
0100000000110011000001110101101011000010001101010010001000100111000001110011010001011001000000111110
0111001110110000111110111100001101000010011011101111101111011101111011110011110110001010101110111001
1111111100001101010110101100110011110110011100010001010101110010000010000011000110101001101000010000
1000010101100100000010110100000011101111101011110101010010111101110110000101111110110101010110000011
0111100111111111001111100000101000011001101011111011000100110001101101010111111011011011000011110001
0001101110000101000100001101111100011010111000110111001110101001101101100000100001010110000111010100
1000110000001010000111110110110110111100010001100010000000110100000101110011000100010100000011110101
