1010100010000001110000101001100001110000010000110111000101110111110011110010011000011010001100001101
0110101000101101011011100010101001110001000111101101010100111110101100100011000110101011000100111110
1111110111011100101101000011011011000000000100110100011001111111010001010011000001000000100110010100
1101000001111111111101000100000000001111101101001000101111100111001101011011111110011001110111000100
0001011100001001100101111100111100101100010101101000010001011101000010000001000011111111001011011100
1101000100010001011101001100100110000011001001101000010000100100010000011011110001001111101100011000
1011000110010111100010000110101010011101001101101100110100001000001110010111000100100011101100111011
1100100101100101001001001110011001101011000000100001110010000111100111100000110010000000000110110010
0011001010100110111001011101100011100001100000010001101001011011111011110100100010010001110100100000
0101001101101011101101000101110100100101101100101010101111100100110101000100110101000111101100110001
0011010011001001000010011101000111011011000100101110100101011010000001001001011001110011100110110010
1001000011110111000110000001101001101011100000000001010011010001010001110000100100101011001010011010
0000110100010011011010110011111111100011101111110000111101000010001101100000000000111110010111110110
1100011001101110101010110010011100000111011101111000101010111011010001011011111110110111110111000110
1101011101100010101000001011101101101001010101001010110010111000010101100010000000101101011100010000
1101110000001011001110101101010000000110111100110010001000000100011000111011111101111100111100000101
1000000001110110100010111111010101111000111110000010100110011101000001101001010111010101010000011111
1000111000100000100011000000101101001100000000000010010110001001000110001100110010000111010011001111
1000001111000110110010111110000101001001111101100001111010001111111100101010001010001001010011010001
0110001011010011110111101100001101111101011010100111100001111011110110011011110010101010101011010010
0110011011111101101010111010001110100100100111010000111010111110101010010011100011110001010000101101
1100001001001011110000111000111010100001111100110010010010010110000011101010011100100100000001100010
0000101101110100011011111100110100100110110001111000100111001010100111001010110100010110100101110110
1110011001010000001100010001010111101111111000001010001111001100110110101010001010000100010001000010
1110110001110010011110100010101101111111110011001011110111010101010000010001011001000110111000110010
0100010000111010110101110101000000000101011000111001110111111111110110110011001111000101100011111000
0101000110001010101011100001101000001001110111110010111001010010000111110110101001010100000100000110
0110001111101100111001110110110101010000000010101010101011001011101011110011111010001111110011011110
1010110010101111100111111001010011111000001101110101101001011001111101111111101000010110110011101011
0010100101010011111001000001001000001010111101111101100010110110100000001001110001010111111001101000
1101100001111111111010011111000000001001100011110000110100100111001010001011110111010110000110111001
0011110001001010001000110110110100001111001011001100111111011001011100000000100110111001111000100111
1101010001010111110010100100110111010010110100000100001010110100010001110100010010110001010010100000
1010011110110000110000001001101011100110100011111010110011010010001000111010100101010110010111000100
1101001010000110100100001000011110001001000010001010110101100011011101001100000110000001101011101110
1101011010100001101111110010010101101010010111101110000101011110000101100100100110000110011000011000
0111100010110011100101010111011111000000011110010000111000100001110101110001001000111110111111111100
1101110001010011110000001001111110101101001011111111100000010010101111000101000011001000100101010110
1101011010101110001100010101011000100001000000011100000001001111111000100010010101101101000001101001
1100111001001100011101010111000000100100111001100001010011011110110000100010010101100011000001111101
0011011000100010001111011101100111101010101010011111110011011010111010000110010101010011000001001110
0101000101000110001111111011011000010101100100110010110010101010100111000010001000010010000011101000
1000110110111001011111111111111011100011101010111100101000110010100011000001010001010110001111110111
0000100110000001101011100100001000001000011011111001000101010010111101100111010010010100101110010110
1100000111010010001010000111101011110100010111101100100000000111001101011001001000111011011001100110
0011110100111010101110011000101000111010010001010111010110000001001010100010011101111111101101011101
1000010001011111011100011110011001000000100111011010011011100000100010011110111110001100001000011011
1001011111101000010010111100010110110100101010011111001000001000010101011100001101010011010010111010
0111101101111101010011100000101110101000010001000100101110011101110011111110001101010001111010111001
0001001001100100110011010000101000000010010100001010101101011101100011101000110110110100100111000001
1110000100110111000010101011110011111011000000010101110101011001110010001100010100001101000100111010
1110100010011101111100011111110010110101101011110011101111100111110110110010100111001010010001001111
1011011001011011000010011111100110001100111011011000001001110010000011010010000100100100011110010011
0100001011101100101101101111000101011010000100001110111111000101010100111010010111001110110000001011
1100010010001011111110110110100101111110101110111110000001111110011001011010000000010011100011101001
1100100010010010110100000010111000011100111110100000001010101010100001101110110000101001000010110110
1001110110011101111001001001011111000010001111011010001100101010110111010110111000100110101100101101
1010101000110110101001100111001000011101010111000101000000110000101110000101101001011001001001000010
0011110000100010110001001011110010011110001110000101100001101011101110101100000011001110101010101110
1001010100100110111111111110010010001100010101111101001110101000000111011011010100010111101001001010
1011111110100110101110100110011111000100000010101010001111101000100110110001000010001010011100110100
1100111110000110100110110001111000001011000111011010010100010101000010001001111100101011010001101100
1001010000000001110110100011001011010111011000110010101000100110000000000010110000101101000011101011
0000011011001011101111101001100010000000000101110000110000110001000110000000001110110111100110000110
1101010010110000101100010010000010011110000001011111111111011011011100111111011000101101000111011001
0110111100011001100010001110110101001100101111100010011101101010000110000100101001010101001001001100
0010000011010011111001100001001000010111010110011100010110100001011111101111001111001010010000110100
1000001100010011000110100010011111011111001001101001010111101011010110110010001010111101111011101010
0011100100101100011100110111110010001101010110010011001001111110100110010010011111000010010010101000
1010100110011000010111001001011000011000110100111000010101110100011001110101111101110100010100111010
0100000010000111001001100110000000101111010010100101111100101111100010001011010111001100111001110011
1101101110011010000101001110000011010101111110011111011000110011110111100100101111000001001001101010
1001000011111101011011010100000110001010011000000010000100001011001100100001100000001100101001011011
1010010000011010000110011101111011111000011100010000000000001101110001111001101100101000010010010001
0110100100101111011001110110110100000101010001111010011010001110100111111010101000110101000010010100
1001011111100001001001000110110000011100000110010001000111101001010101010011000000010111011100111011
0111110000100100101001100100101110101111111011111000010001101101110100111110100011010010001011111110
1111110110010011010010011010011101111011101111010101010111001101100110111100010010111010101110001111
1110000010000011001100111011010000100111000011011101010001011010001101001001111001100101011001101100
0100001000001110111011101010010111111010100000111011100011111000101111100001100011101011110111110110
1011111011111110011111101000010000101001010001011110101111110011001011101011000110011010001011000111
0010111110000000111100000101001011010000001100001010010111011000011001111111011001000100101111101101
0110101011111000000001000001101111000010111110100011110101110000111011110000101001110100010100000000
1010101100110100101101110111000001001010101110001100110101001011110010101111001101001011100000001000
0001001110010010111001101001111111100111111101010011101000010100111111010001101101011110101001000001
1100011110001111101001111010101011011111110110000101111011101101101111011101100100101101000101000111
0010000011001001110001101100100111001111011011100011001001000111000110001100000001100110001010001110
0011000100101001001010000110011010011111001111011111100011100101000000001001010100101100101011000101
0010001111100010000101101101100001000100110100010000110011101100101101111101010110100110111101111101
0011001000011000010110111101101110001110010010010001010010110101100100000111001100000010110111011000
1100001111100001001011111100001101000101010101011111001100001111001100010000101100001111000100011000
0100101110000001111110010011110110101010011111110001010100110110011001000000101001100010000001000101
1111011000110000101101010101001011011010001010011111001101110110101010001001011111010010100110001110
1110110001011100001111010011011000001001011101101101101000011111111100100111000011111101011100101001
0011011110010011000100011011011010100110000100111011000111101100010101111111000110111010101101110011
0111011011101010000000001011000000110111001100011101010011011110110000001000101111001100010011011100
1001001011000100101100100100010110011101101010011101011010110111101110100110111101000011111000101101
1010101011000011011000101001000001100011110111001111110101111010010001101110010001000111100100101011
1101011011000100011011000000111000111011010111111001100001010101000001110010000010000101001010111111
1100000100100001111111011000100000101011101101000101000100000010001100110100100001000110010110011010
